#,#,#,#,#,#,#,#,#,#,#,#,#,#,#
#,T, , , , , , , , , , , , ,#
#, , , , , , , , , ,M, , , ,#
#, , , , , , , , ,M,M, , , ,#
#, , ,t,t, , , , ,M,M, , , ,#
#, ,t,t,t,t, , , ,M,M, , , ,#
#, ,t,t,t,t, , ,M,M,M,M, , ,#
#, ,t,t,t,t, , ,M,M,M,M, , ,#
#, ,t,t,t,t, ,M,M,M,M,M,M, ,#
#, , ,t,t, , ,M,M,M,M,M,M, ,#
#, , ,t,t, , ,M, ,M,M, ,M, ,#
#, , ,t,t, , ,M,M,M,M,M,M, ,#
#, , ,t,t, , ,M,M, , ,M,M, ,#
#, , ,t,t, , ,M,M, , ,M,M, ,#
#, , ,t,t, , ,M,M, , ,M,M, ,#
#, , ,t,t, , , , ,L,L, , , ,#
#, , , , , ,L, , ,P, , , , ,#
#,#,#,#,#,#,#,#,#,#,#,#,#,#,#
1000,,,,,,,,,,,,,
