#,#,#,#,#,#,#,#,#,#,#,#
#,P,w,w,w, , , , , , ,#
#, ,w,w,w, ,w,w,w w, ,#
#, ,w,T,T, ,w,w, , , ,#
#, ,w,T,T,w,w,w, ,w,w,#
#, ,w,w,w,w,w,w, , , ,#
#, ,w,w, , , ,w,w,w, ,#
#, , , , ,w, ,w,w, , ,#
#,w,w, ,w,w, , , , ,w,#
#,w, , , , ,w,w,w,w,w,#
#,#,#,#,#,#,#,#,#,#,#,#
1000,,,,,,,,,,
