#,#,#,#,#,#,#,#,#,#,#,#,#,#,#
#, , , , , , , , ,w,w,w,w,w,#
#, ,w,w, ,w,w,w, ,w,w,w,w,w,#
#,t,w,w, ,w,w,w, ,w,w,w,w,w,#
#,t,w,w, ,w,w,w, ,w,w,w,w,w,#
#,t,w,w, ,w,w,w, ,w,w,w,w,w,#
#,t, , , ,w,w,w, ,w,w,w,w,w,#
#,t,w, ,w,w,w,w, ,w,w,w,w,w,#
#, , , ,w,w,w,w, , ,w,w,w,w,#
#, ,t,t,w,w,w, , , , ,w, ,w,#
#, , ,M,M,L, ,P,t,t, , , , ,#
#,t, ,M, ,L,L,L, , ,t, ,t, ,#
#, , , , ,L,L,L, ,t,t, , ,t,#
#,t,t,t,T, , , , , , , ,t,t,#
#,#,#,#,#,#,#,#,#,#,#,#,#,#,#
1000,,,,,,,,,,,,,
