#,#,#,#,#,#,#,#,#,#,#,#
#, , , , , , , , , , ,#
#, , , , , , , , , , ,#
#, ,t,t,t, ,t,t, , , ,#
#, ,t,t,t, ,t,t, , , ,#
#, ,B,T,T,T,T,M, , , ,#
#, ,B,T,T,T,T,M, , , ,#
#, ,B,T,T,T,T,M, , , ,#
#, ,B,T,T,T,T,M, , , ,#
#,P,B,T,T,T,T,M, , , ,#
#,#,#,#,#,#,#,#,#,#,#,#
1000,,,,,,,,,,
