#,#,#,#,#,#,#,#,#,#,#,#
#,t,t,t,t,t,t,t,t,t,t,#
#,t,t,t,t,t,t,t,t,t,t,#
#,t,B,t,t,P,t,t,t,t,t,#
#,B,t,t,B, , , , , , ,#
#,B,t,t, , , , , , , ,#
#, , , ,B, , , , , , ,#
#, , , , , ,B,B, , , ,#
#,t, ,B, ,B,B,B, , , ,#
#,T, , ,t,B,B,B, , , ,#
#,#,#,#,#,#,#,#,#,#,#,#
1000,,,,,,,,,,
