#,#,#,#,#,#,#,#,#,#,#,#
#,w,w,w,w,w,w,w,w,w,w,#
#,w,w,w,w,w,w,w,w,w,w,#
#,w,w,w,w,w,m,w,w,w,w,#
#,w,w,w,w,m,m,m,w,w,w,#
#,w, , ,w, ,T,m,w,w,w,#
#,w, ,w,w, , ,m,w,w,w,#
#, , ,w,w,w,w,w,w,w,w,#
#, , ,t,t,t,t,t,t, , ,#
#,P, , ,t,t,t,t,t, , ,#
#,#,#,#,#,#,#,#,#,#,#,#
1000,,,,,,,,,,
