#,#,#,#,#,#,#,#,#,#,#,#
#, ,m,m,m,m, , , , ,T,#
#, ,m,w,w,w, ,m,m,m,m,#
#, ,m,w,w,w, ,w,w,w,m,#
#, ,m,w,w,w, ,w,w,w,m,#
#, ,m,w,w,w, ,w,w,w,m,#
#, ,m,w,w,w, ,w,w,w,m,#
#, ,m,w, , , ,m,m,m,m,#
#, ,m,m, ,m,m,m,m,m,m,#
#,P, , , ,m,m,m,m,m,m,#
#,#,#,#,#,#,#,#,#,#,#,#
1000,,,,,,,,,,
