#,#,#,#,#,#,#,#,#,#,#,#
#,T, , , , , , , , ,T,#
#, , , , , , , , , , ,#
#, , , , , , , , , , ,#
#, , , , , , , , , , ,#
#,T, , , , , , , , ,T,#
#, , , , , , , , , , ,#
#, , , , , , , , , , ,#
#, , , , , , , , , , ,#
#,P, , , , , , , , ,T,#
#,#,#,#,#,#,#,#,#,#,#,#
1000,,,,,,,,,,
