#,#,#,#,#,#,#,#,#,#
#, ,M, ,M,M,M,M, ,#
#, , , ,M, , , , ,#
#, ,M, , ,M, ,L, ,#
#, ,M,M, ,T,L,L, ,#
#, ,M,M,L,L, , ,P,#
#, ,M, ,L, , ,M, ,#
#, , , , , ,L,L,L,#
#,M, ,M, ,M,L,L,L,#
#,#,#,#,#,#,#,#,#,#
1000,,,,,,,,
