#,#,#,#,#,#,#,#,#,#,#,#
#, , , , , , , , , , ,#
#, , , , , , , , , , ,#
#, , , , , , ,T, , , ,#
#, , , , , , , , , , ,#
#, , , , ,P, , , , , ,#
#, , , , , , , , , , ,#
#, , , , , , , , , , ,#
#, , , , , , , , , , ,#
#, , , , , , , , , , ,#
#,#,#,#,#,#,#,#,#,#,#,#
1000,,,,,,,,,,
