#,B,B,B,B,B,B,B,B,B,B,B,B,B,#
#,B,T, , , ,B,B, ,B, , , , ,#
#, ,B,B, ,B, ,B, , , , , , ,#
#, , , , , , , , ,M,B,B, , ,#
#,M,M,M,M,M,M,M,M, ,B, , ,B,#
#,B, , , , , , , ,B, ,M, ,B,#
#,B, , ,M, ,t,t,t,t, ,M, ,B,#
#, , ,M, , , , , , , ,M, ,B,#
#, , ,P,M,t,t, , , , ,M, ,B,#
#, ,t,M, , , ,t,t,t, , , , ,#
#, ,t, , , , ,t, ,t,t, , , ,#
#, , , ,t,t, , , , ,t,t, ,t,#
#, ,t, , ,t, , ,t, , , , ,t,#
#, , ,t,t,t,t, , , , ,t, , ,#
#,#,#,#,#,#,#,#,#,#,#,#,#,#,#
1000,,,,,,,,,,,,,
