#,#,#,#,#,#,#,#,#,#,#,#,#,#,#
#,t, ,t, ,t, ,t,t, , , , , ,#
#, , , , , , , , , ,t, ,t, ,#
#,t, ,t,t,t, ,t, ,t,t,t, , ,#
#, , ,t, , , ,t, , ,t, ,t, ,#
#, ,t,t, ,t,t,t,t, ,t, ,t, ,#
#, ,t,t, , , , , ,t, , ,t, ,#
#, ,t, ,t,t,t, ,t, , ,t, , ,#
#, , , , , , ,t, , ,t,t,t, ,#
#,t, ,M, ,t, ,t,t, ,t,t,t, ,#
#, ,M,M, ,t,L,L, , , , , , ,#
#, ,T,M, , ,L,L, ,t,t,t, ,t,#
#, ,M, ,M, ,M,L,P, ,t,t, , ,#
#, , , , , , ,L, ,t,t,t,t, ,#
#,#,#,#,#,#,#,#,#,#,#,#,#,#,#
1000,,,,,,,,,,,,,
