#,#,#,#,#,#,#,#,#,#,#,#,#,#,#
#,P,w,w,w,w,w,w,w,w,w,t,t,t,#
#, ,w,w,w,w,w,w,w w,w,t,t,t,#
#, ,w,T,T,T, , ,w,w,w,t,t,t,#
#, ,w,w,w,w,w, ,w,w,w,t,t,t,#
#, ,w,w,w,w,w, ,w,w,w,w,w,w,#
#, , , , , , , ,w,w,w,w,w,w,#
#,w, ,w,w,w,w, ,w,w,w,T,T,T,#
#,w, ,w,w,w,w,m,w,w,w,T,T,T,#
#,w, , , , , , , , , ,T,T,T,#
#,#,#,#,#,#,#,#,#,#,#,#,#,#,#
1000,,,,,,,,,,,,,
