#,#,#,#,#,#,#,#,#,#,#,#
#, , , , , , , , , , ,#
#, ,T, , ,M, , , ,T, ,#
#, , , , , , , , , , ,#
#, ,M,M,M,M,M,M,M,M, ,#
#, ,M,M,M,M,M,M,M,M, ,#
#, , , , , , , , , , ,#
#, , , , , , , , , , ,#
#, ,M, , , , , , ,T, ,#
#,P,M, , , , , , , , ,#
#,#,#,#,#,#,#,#,#,#,#,#
1000,,,,,,,,,,
