#,#,#,#,#
#,P, ,M,#
#, ,L,L,#
#, , ,T,#
#,#,#,#,#
1000,,,
