#,B,B,B,B,B,B,B,B,B,B,B,B,B,#
#,B, , , , ,B,B, ,B, , , , ,#
#, ,B,B, ,B, ,B, , , , , , ,#
#, , , , , , , , ,B,B,B, , ,#
#,B,B,B,B,B, ,B,B, ,B, ,P,B,#
#,B, , , , , , , , , , , ,B,#
#,B, , ,M, ,t,t,t,t, ,B, ,B,#
#, , ,M, , , , , , ,t,B, ,B,#
#, , ,T,M,t,t, , , , ,B, ,B,#
#, ,t,M, , , ,t,t,t, , , , ,#
#, ,t, , , , ,t, ,t,t, , , ,#
#, , , ,t,t, , , , ,t,t, ,t,#
#, ,t, , ,t, , ,t, , , , ,t,#
#, , ,t,t,t,t, , , , ,t, , ,#
#,#,#,#,#,#,#,#,#,#,#,#,#,#,#
1000,,,,,,,,,,,,,
