#,#,#,#,#,#,#,#,#,#,#,#
#,T,T,T,T,T,T,T,T,T,T,#
#,T,T,T,T,T,T,T,T,T,T,#
#,T,T,T,T,T,T,T,T,T,T,#
#,T,T,T,T,T,T,T,T,T,T,#
#,T,T,T,T,T,T,T,T,T,T,#
#,T,T,T,T,T,T,T,T,T,T,#
#,T,T,T,T,#,#,#,T,T, ,#
#,T,T,T,T,#,w,#, , , ,#
#,T,T,T,T,t,P,#, , , ,#
#,#,#,#,#,#,#,#,#,#,#,#
1000,,,,,,,,,,
