#,#,#,#,#,#,#,#,#,#,#,#
#,P, , , , , , , , , ,#
#, , , , , , , , , , ,#
#, , , , , , , , , , ,#
#, , , , , , , , , , ,#
#, , , , , , , , , , ,#
#, , , , , , , , , , ,#
#, , , , , , , , , , ,#
#, , , , , , , , , , ,#
#, , , , , , , , , ,T,#
#,#,#,#,#,#,#,#,#,#,#,#
1000,,,,,,,,,,
